5 21 64 36 5
0 0 0 3 0 0 0 3 0 0 0 3 0 0 0 3 0 0 0 3 0 0 0 4 0 0 0 8 0 0 0 3 0 0 0 3 0 0 0 3 0 0 0 3 0 0 0 3 0 0 0 3 0 0 0 3 0 0 0 3 0 0 0 3 0 0 0 3 0 0 0 3 0 0 0 3 0 0 0 3 0 0 0 3 0 0 0 3 0 0 0 3 0 0 0 3 0 0 0 7 0 0 0 6 0 0 0 3 0 0 0 3 0 0 0 3 0 0 0 3 0 0 0 3 0 0 0 9 0 0 0 7 0 0 0 8 0 0 0 3 0 0 0 3 
0 0 0 3 0 0 0 3 0 0 0 3 0 0 0 3 0 0 0 3 0 0 0 3 0 0 0 3 0 0 0 3 0 0 0 3 0 0 0 3 0 0 0 3 0 0 0 3 0 0 0 3 0 0 0 3 0 0 0 3 0 0 0 3 0 0 0 3 0 0 0 3 0 0 0 3 0 0 0 3 0 0 0 3 0 0 0 3 0 0 0 3 0 0 0 9 0 0 0 3 0 0 0 3 0 0 0 3 0 0 0 3 0 0 0 3 0 0 0 3 0 0 0 3 0 0 0 9 0 0 0 3 0 0 0 3 0 0 0 3 0 0 0 3 
0 0 0 3 0 0 0 3 0 0 0 3 0 0 0 3 0 0 0 3 0 0 0 3 0 0 0 3 0 0 0 3 0 0 0 3 0 0 0 3 0 0 0 3 0 0 0 3 0 0 0 3 0 0 0 3 0 0 0 3 0 0 0 3 0 0 0 3 0 0 0 3 0 0 0 3 0 0 0 3 0 0 0 3 0 0 0 3 0 0 0 3 0 0 0 3 0 0 0 3 0 0 0 3 0 0 0 3 0 0 0 3 0 0 0 3 0 0 0 3 0 0 0 3 0 0 0 3 0 0 0 3 0 0 0 3 0 0 0 3 0 0 0 3 
0 0 0 3 0 0 0 3 0 0 0 3 0 0 0 3 0 0 0 3 0 0 0 3 0 0 0 3 0 0 0 3 0 0 0 3 0 0 0 3 0 0 0 3 0 0 0 3 0 0 0 3 0 0 0 3 0 0 0 3 0 0 0 3 0 0 0 3 0 0 0 3 0 0 0 3 0 0 0 3 0 0 0 3 0 0 0 3 0 0 0 3 0 0 0 3 0 0 0 3 0 0 0 3 0 0 0 3 0 0 0 3 0 0 0 3 0 0 0 3 0 0 0 3 0 0 0 3 0 0 0 3 0 0 0 3 0 0 0 3 0 0 0 3 
0 0 0 3 0 0 0 3 0 0 0 3 0 0 0 3 0 0 0 3 0 0 0 3 0 0 0 3 0 0 0 3 0 0 0 3 0 0 0 3 0 0 0 3 0 0 0 3 0 0 0 3 0 0 0 3 0 0 0 3 0 0 0 3 0 0 0 3 0 0 0 3 0 0 0 3 1 2 6 7 2 20 0 0 64 9 55 17 5 17 36 51 35 41 0 47 55 21 16 11 2 24 20 21 39 31 27 44 27 29 27 2 23 50 1 31 15 17 6 41 40 34 3 36 38 37 6 53 35 25 37 43 7 28 9 63 52 19 56 27 58 12 38 26 42 34 49 15 6 5 0 6 0 0 0 3 0 0 0 3 0 0 0 3 0 0 0 3 0 0 0 3 0 0 0 3 0 0 0 3 0 0 0 3 0 0 0 3 0 0 0 3 0 0 0 3 0 0 0 3 0 0 0 3 0 0 0 3 0 0 0 3 0 0 0 3 
0 0 0 3 0 0 0 3 0 0 0 3 0 0 0 3 0 0 0 3 0 0 0 3 0 0 0 3 0 0 0 3 0 0 0 3 0 0 0 3 0 0 0 3 0 0 0 3 0 0 0 3 0 0 0 3 0 0 0 8 0 0 0 3 0 0 0 3 0 0 0 3 0 0 0 7 0 0 0 3 0 0 0 3 0 0 0 3 0 0 0 3 0 0 0 3 0 0 0 3 0 0 0 3 0 0 0 3 0 0 0 3 0 0 0 3 0 0 0 3 0 0 0 3 0 0 0 3 0 0 0 3 0 0 0 3 0 0 0 3 0 0 0 3 
0 0 0 3 0 0 0 3 0 0 0 3 0 0 0 3 0 0 0 3 0 0 0 3 0 0 0 3 2 6 0 1 0 0 0 3 0 0 0 3 0 0 0 3 0 0 0 3 0 0 0 7 0 0 0 8 0 0 0 3 0 0 0 3 0 0 0 7 0 0 0 6 0 0 0 3 0 0 0 3 0 0 0 3 0 0 0 3 0 0 0 3 0 0 0 3 0 0 0 3 0 0 0 3 0 0 0 3 0 0 0 3 0 0 0 3 0 0 0 3 0 0 0 3 0 0 0 3 0 0 0 3 0 0 0 3 0 0 0 10 0 0 0 3 
0 0 0 3 0 0 0 3 0 0 0 3 0 0 0 3 0 0 0 3 0 0 0 3 0 0 0 3 0 0 0 3 0 0 0 3 0 0 0 3 0 0 0 3 0 0 0 9 0 0 0 3 0 0 0 3 0 0 0 3 0 0 0 9 0 0 0 3 0 0 0 3 0 0 0 3 0 0 0 3 0 0 0 3 0 0 0 3 0 0 0 3 0 0 0 3 0 0 0 3 0 0 0 3 0 0 0 3 0 0 0 3 0 0 0 3 0 0 0 3 0 0 0 3 0 0 0 3 0 0 0 3 0 0 0 9 0 0 0 6 1 2 6 7 2 20 0 0 64 9 55 17 13 17 36 51 35 41 0 47 55 21 16 11 2 24 20 21 39 31 27 44 27 29 27 2 23 50 1 34 15 17 6 41 40 34 3 36 38 37 6 53 35 25 37 43 7 28 18 63 52 19 48 27 1 12 38 26 42 2 49 15 6 5 0 10 
0 0 0 3 0 0 0 3 0 0 0 3 0 0 0 3 0 0 0 3 0 0 0 3 0 0 0 3 0 0 0 3 0 0 0 3 0 0 0 3 0 0 0 3 0 0 0 3 0 0 0 3 0 0 0 3 0 0 0 3 0 0 0 3 0 0 0 3 0 0 0 3 0 0 0 3 0 0 0 3 0 0 0 3 0 0 0 3 0 0 0 3 0 0 0 3 0 0 0 3 0 0 0 3 0 0 0 3 0 0 0 3 0 0 0 3 0 0 0 3 0 0 0 3 0 0 0 3 0 0 0 7 1 37 2 7 2 20 0 0 64 9 55 17 5 17 36 51 35 41 0 47 55 21 24 11 2 24 20 21 39 31 27 44 27 29 54 2 23 50 1 31 15 17 6 41 40 34 3 36 38 37 6 47 35 25 37 43 7 28 18 63 52 19 48 27 1 12 38 26 42 34 49 15 6 5 0 10 0 0 0 3 0 0 0 3 
0 0 0 3 0 0 0 3 0 0 0 3 0 0 0 3 0 0 0 3 0 0 0 3 0 0 0 3 0 0 0 3 0 0 0 3 0 0 0 3 0 0 0 3 0 0 0 3 0 0 0 3 0 0 0 3 0 0 0 3 0 0 0 3 0 0 0 7 1 37 6 7 2 20 0 0 64 9 55 17 5 17 36 51 35 41 0 47 42 21 24 11 2 24 20 21 39 31 27 44 27 62 54 2 23 50 1 31 15 17 6 41 40 34 3 36 38 37 6 53 35 25 37 43 7 28 18 63 52 19 48 27 1 12 38 26 42 34 49 15 6 5 0 7 0 0 0 10 0 0 0 3 1 2 6 7 2 20 0 0 64 9 55 17 13 17 36 51 35 41 0 39 55 21 16 11 2 24 20 21 39 31 27 44 27 29 27 2 23 50 1 34 15 17 6 41 40 34 3 36 38 37 6 53 35 25 37 43 7 28 18 63 52 19 48 27 1 12 38 26 42 2 49 15 6 5 0 6 0 0 0 3 0 0 0 3 0 0 0 3 0 0 0 3 0 0 0 3 0 0 0 3 0 0 0 3 0 0 0 3 0 0 0 3 0 0 0 3 0 0 0 9 0 0 0 3 0 0 0 3 0 0 0 3 0 0 0 3 
0 0 0 3 0 0 0 3 0 0 0 3 0 0 0 3 0 0 0 3 0 0 0 3 0 0 0 3 0 0 0 3 0 0 0 3 0 0 0 3 0 0 0 3 0 0 0 3 0 0 0 3 0 0 0 3 0 0 0 3 0 0 0 9 0 0 0 9 0 0 0 9 0 0 0 3 0 0 0 7 0 0 0 3 0 0 0 3 0 0 0 3 0 0 0 3 0 0 0 3 0 0 0 3 0 0 0 3 0 0 0 3 0 0 0 3 0 0 0 3 0 0 0 3 0 0 0 3 0 0 0 3 0 0 0 3 0 0 0 3 0 0 0 17 
0 0 0 3 0 0 0 3 0 0 0 3 0 0 0 3 1 2 6 7 2 20 0 0 64 9 55 17 5 17 36 51 35 41 0 47 55 21 24 11 2 24 20 21 39 18 27 44 27 29 27 2 23 50 1 31 15 17 6 41 40 34 3 36 38 37 6 53 35 25 37 43 7 28 18 57 52 19 48 27 1 12 38 26 42 34 49 15 6 5 0 6 0 0 0 3 0 0 0 3 0 0 0 3 1 2 6 7 2 20 0 0 64 9 55 17 5 17 36 51 35 41 0 47 55 21 16 11 2 24 20 21 39 31 27 44 27 29 27 2 23 15 1 31 15 17 6 41 40 34 3 36 38 37 6 53 35 25 6 43 7 28 18 63 52 19 48 27 1 12 38 26 42 34 49 15 6 5 0 6 0 0 0 3 0 0 0 3 0 0 0 3 0 0 0 3 0 0 0 3 0 0 0 3 0 0 0 3 0 0 0 3 0 0 0 3 0 0 0 3 0 0 0 3 0 0 0 3 0 0 0 3 0 0 0 -1 0 0 0 3 0 0 0 3 0 0 0 3 0 0 0 3 0 0 0 3 0 0 0 3 0 0 0 -1 0 0 0 3 0 0 0 3 0 0 0 3 0 0 0 3 0 0 0 9 0 0 0 3 
0 0 0 3 0 0 0 3 0 0 0 3 0 0 0 7 0 0 0 -1 0 0 0 3 0 0 0 3 0 0 0 7 0 0 0 3 0 0 0 3 0 0 0 3 0 0 0 3 0 0 0 3 0 0 0 3 0 0 0 3 0 0 0 3 0 0 0 3 0 0 0 3 0 0 0 3 0 0 0 3 0 0 0 3 0 0 0 3 0 0 0 3 0 0 0 3 0 0 0 3 0 0 0 3 0 0 0 3 0 0 0 3 0 0 0 3 0 0 0 3 0 0 0 3 0 0 0 3 0 0 0 3 0 0 0 3 0 0 0 3 0 0 0 3 
0 0 0 3 0 0 0 7 0 0 0 6 0 0 0 3 0 0 0 3 0 0 0 7 0 0 0 6 0 0 0 3 0 0 0 3 0 0 0 3 0 0 0 3 0 0 0 3 0 0 0 3 0 0 0 3 0 0 0 3 0 0 0 3 0 0 0 3 0 0 0 3 0 0 0 3 0 0 0 3 0 0 0 3 1 6 6 7 2 20 0 0 64 9 55 17 5 17 36 51 35 41 0 47 55 21 24 11 2 24 20 21 39 31 27 44 27 29 54 2 23 50 1 31 15 17 6 36 40 34 3 36 38 37 6 53 35 25 37 43 7 28 18 63 52 19 48 27 1 12 38 1 42 34 49 15 6 5 0 5 0 0 0 3 0 0 0 3 0 0 0 3 0 0 0 3 0 0 0 3 0 0 0 3 0 0 0 3 0 0 0 3 0 0 0 3 0 0 0 3 0 0 0 3 0 0 0 3 0 0 0 3 0 0 0 3 
0 0 0 9 0 0 0 3 0 0 0 3 0 0 0 3 0 0 0 9 0 0 0 3 0 0 0 3 0 0 0 3 0 0 0 3 0 0 0 3 0 0 0 3 0 0 0 3 0 0 0 3 0 0 0 3 0 0 0 3 0 0 0 3 0 0 0 3 0 0 0 3 0 0 0 3 0 0 0 3 0 0 0 9 0 0 0 3 0 0 0 3 0 0 0 3 0 0 0 3 0 0 0 3 0 0 0 3 0 0 0 3 0 0 0 3 0 0 0 3 0 0 0 3 0 0 0 3 0 0 0 3 0 0 0 3 1 2 6 7 2 20 0 0 64 9 55 17 5 17 36 51 35 41 0 47 55 21 24 11 2 24 20 21 39 31 27 44 27 29 54 2 23 50 1 31 15 17 6 41 40 34 3 36 38 37 6 53 35 25 37 43 7 28 18 63 52 19 48 27 9 12 38 26 42 34 49 15 6 5 0 6 0 0 0 3 
0 0 0 3 0 0 0 3 0 0 0 3 0 0 0 3 0 0 0 3 0 0 0 3 0 0 0 3 0 0 0 3 0 0 0 3 0 0 0 3 0 0 0 3 0 0 0 3 0 0 0 3 0 0 0 3 0 0 0 3 0 0 0 3 0 0 0 3 1 2 6 7 2 20 0 0 64 9 55 17 5 17 36 51 35 41 0 47 55 21 24 15 2 24 20 21 39 31 27 44 27 4 27 2 23 50 1 31 15 17 6 41 40 34 51 36 38 37 6 53 35 25 37 43 7 28 18 63 52 19 48 27 1 12 38 26 42 34 49 15 6 5 0 6 0 0 0 3 0 0 0 9 0 0 0 3 0 0 0 3 0 0 0 3 0 0 0 3 0 0 0 3 0 0 0 3 0 0 0 3 0 0 0 3 0 0 0 3 0 0 0 3 0 0 0 3 0 0 0 3 0 0 0 3 0 0 0 7 0 0 0 3 0 0 0 3 
0 0 0 3 0 0 0 3 0 0 0 3 0 0 0 3 0 0 0 3 0 0 0 3 0 0 0 3 0 0 0 3 0 0 0 3 0 0 0 3 0 0 0 3 0 0 0 3 0 0 0 3 0 0 0 3 0 0 0 3 0 0 0 3 0 0 0 7 0 0 0 3 0 0 0 9 0 0 0 3 0 0 0 3 0 0 0 3 0 0 0 3 0 0 0 3 0 0 0 3 0 0 0 3 0 0 0 3 0 0 0 3 0 0 0 3 0 0 0 3 0 0 0 3 0 0 0 7 0 0 0 6 0 0 0 3 0 0 0 3 0 0 0 3 
0 0 0 3 0 0 0 3 0 0 0 3 0 0 0 3 0 0 0 3 0 0 0 3 0 0 0 3 0 0 0 3 0 0 0 3 0 0 0 3 0 0 0 3 0 0 0 3 0 0 0 3 0 0 0 3 0 0 0 7 0 0 0 6 0 0 0 3 0 0 0 3 0 0 0 3 0 0 0 3 0 0 0 3 0 0 0 3 0 0 0 3 0 0 0 3 0 0 0 3 0 0 0 3 0 0 0 3 0 0 0 3 0 0 0 3 0 0 0 3 0 0 0 9 0 0 0 3 0 0 0 3 0 0 0 3 0 0 0 3 0 0 0 3 
0 0 0 3 0 0 0 3 0 0 0 3 0 0 0 3 0 0 0 3 0 0 0 3 0 0 0 3 0 0 0 3 0 0 0 3 0 0 0 3 0 0 0 3 0 0 0 3 0 0 0 3 0 0 0 9 0 0 0 3 0 0 0 3 0 0 0 3 0 0 0 3 0 0 0 3 0 0 0 3 0 0 0 3 0 0 0 3 0 0 0 3 0 0 0 3 0 0 0 3 0 0 0 3 0 0 0 3 0 0 0 3 0 0 0 3 0 0 0 3 0 0 0 3 0 0 0 3 0 0 0 3 0 0 0 3 0 0 0 3 0 0 0 3 
0 0 0 3 0 0 0 3 0 0 0 3 0 0 0 3 0 0 0 3 0 0 0 3 0 0 0 3 0 0 0 3 0 0 0 3 0 0 0 3 0 0 0 3 0 0 0 3 0 0 0 3 0 0 0 3 0 0 0 3 0 0 0 3 0 0 0 3 0 0 0 3 0 0 0 3 0 0 0 3 0 0 0 3 0 0 0 3 0 0 0 3 0 0 0 3 0 0 0 3 0 0 0 3 0 0 0 3 0 0 0 3 0 0 0 3 0 0 0 3 0 0 0 3 0 0 0 3 0 0 0 3 0 0 0 3 0 0 0 3 0 0 0 3 
0 0 0 3 0 0 0 3 0 0 0 3 0 0 0 3 0 0 0 3 0 0 0 3 0 0 0 3 0 0 0 3 0 0 0 3 0 0 0 3 0 0 0 3 0 0 0 3 0 0 0 3 0 0 0 3 0 0 0 3 0 0 0 3 0 0 0 3 0 0 0 3 0 0 0 3 0 0 0 3 0 0 0 3 0 0 0 3 0 0 0 3 0 0 0 3 0 0 0 3 0 0 0 3 0 0 0 3 0 0 0 3 0 0 0 3 0 0 0 3 0 0 0 3 0 0 0 3 0 0 0 3 0 0 0 3 0 0 0 3 0 0 0 3 
0 0 0 3 0 0 0 3 0 0 0 3 0 0 0 3 0 0 0 3 0 0 0 3 0 0 0 3 0 0 0 3 0 0 0 3 0 0 0 3 0 0 0 3 0 0 0 3 0 0 0 3 0 0 0 3 0 0 0 3 1 2 6 7 2 20 0 0 64 9 55 17 5 17 36 51 35 41 0 47 55 21 16 11 25 24 20 21 39 31 27 44 27 29 27 2 23 50 1 31 15 17 6 41 40 34 3 36 38 37 6 53 35 25 37 43 7 28 9 63 52 19 48 27 1 12 38 26 42 34 49 15 6 5 0 6 0 0 0 3 0 0 0 3 0 0 0 3 0 0 0 3 0 0 0 3 0 0 0 3 0 0 0 3 0 0 0 3 0 0 0 3 0 0 0 3 0 0 0 3 0 0 0 3 0 0 0 3 0 0 0 3 0 0 0 3 0 0 0 3 0 0 0 3 0 0 0 3 0 0 0 3 0 0 0 3 
0 0 0 3 0 0 0 3 0 0 0 3 0 0 0 3 0 0 0 3 0 0 0 3 0 0 0 3 0 0 0 3 0 0 0 -1 0 0 0 3 0 0 0 3 1 2 6 7 2 20 0 0 64 9 55 17 5 17 36 51 35 41 0 47 55 21 16 11 2 24 20 21 39 31 27 44 27 29 27 2 23 50 1 34 15 17 6 41 40 34 3 36 38 23 6 53 35 25 37 43 7 28 18 63 52 19 48 27 1 12 38 26 42 15 49 15 6 5 0 6 0 0 0 3 0 0 0 3 0 0 0 7 1 2 6 7 2 20 0 0 64 9 55 17 5 17 36 51 35 41 0 47 55 21 16 11 2 24 20 21 39 31 27 44 27 54 27 2 23 15 1 31 15 17 6 41 40 34 3 36 38 37 6 53 35 25 37 43 7 28 18 63 52 19 48 27 1 12 38 26 42 34 49 15 6 5 0 6 0 0 0 3 0 0 0 3 0 0 0 3 0 0 0 3 0 0 0 3 0 0 0 3 0 0 0 3 0 0 0 3 0 0 0 3 0 0 0 3 0 0 0 3 0 0 0 3 0 0 0 3 0 0 0 3 1 2 6 7 2 20 0 0 64 9 55 17 5 17 36 51 35 41 0 47 55 21 24 11 2 24 20 21 39 31 27 44 27 62 54 2 23 50 1 31 15 17 6 41 40 34 3 36 38 37 6 53 35 25 37 43 7 28 18 63 52 19 48 27 1 12 38 26 42 34 49 15 6 5 0 6 0 0 0 3 0 0 0 3 0 0 0 3 0 0 0 3 0 0 0 3 
0 0 0 3 0 0 0 3 0 0 0 3 0 0 0 3 0 0 0 3 0 0 0 3 0 0 0 3 0 0 0 3 0 0 0 3 0 0 0 3 0 0 0 7 0 0 0 3 0 0 0 7 0 0 0 6 0 0 0 7 0 0 0 3 0 0 0 3 0 0 0 3 0 0 0 3 0 0 0 3 0 0 0 3 0 0 0 3 0 0 0 3 0 0 0 3 0 0 0 3 0 0 0 3 0 0 0 3 0 0 0 3 0 0 0 3 0 0 0 7 0 0 0 3 0 0 0 3 0 0 0 3 0 0 0 3 0 0 0 3 0 0 0 3 
0 0 0 3 0 0 0 3 0 0 0 3 0 0 0 3 0 0 0 3 0 0 0 3 1 2 6 7 2 20 0 0 64 9 55 17 5 17 36 51 35 41 0 47 55 21 16 11 2 24 20 21 39 31 27 44 27 29 27 2 23 50 1 34 15 17 6 41 40 34 3 48 38 37 6 53 35 25 37 43 7 28 18 63 52 19 48 27 1 12 38 26 42 15 49 15 6 5 0 6 0 0 0 3 0 0 0 7 0 0 0 6 0 0 0 3 0 0 0 9 0 0 0 7 0 0 0 6 0 0 0 3 0 0 0 3 0 0 0 3 0 0 0 3 0 0 0 3 0 0 0 3 0 0 0 3 0 0 0 3 0 0 0 3 0 0 0 3 0 0 0 3 0 0 0 3 0 0 0 3 0 0 0 7 0 0 0 6 0 0 0 3 0 0 0 -1 0 0 0 3 0 0 0 3 0 0 0 3 0 0 0 3 0 0 0 3 
0 0 0 3 0 0 0 3 0 0 0 3 0 0 0 3 0 0 0 3 0 0 0 7 0 0 0 3 0 0 0 9 0 0 0 3 0 0 0 3 0 0 0 3 0 0 0 9 0 0 0 3 0 0 0 3 0 0 0 3 0 0 0 3 0 0 0 3 0 0 0 3 0 0 0 3 0 0 0 3 0 0 0 3 0 0 0 3 0 0 0 3 0 0 0 3 0 0 0 3 0 0 0 3 0 0 0 9 0 0 0 3 0 0 0 3 0 0 0 3 0 0 0 3 0 0 0 3 0 0 0 3 0 0 0 3 0 0 0 3 0 0 0 3 
0 0 0 3 0 0 0 3 0 0 0 3 0 0 0 7 0 0 0 6 0 0 0 10 0 0 0 3 0 0 0 3 0 0 0 3 0 0 0 3 0 0 0 3 0 0 0 3 0 0 0 3 0 0 0 3 0 0 0 3 0 0 0 3 0 0 0 3 0 0 0 3 0 0 0 3 0 0 0 3 0 0 0 3 0 0 0 3 0 0 0 3 0 0 0 3 0 0 0 3 0 0 0 3 0 0 0 3 0 0 0 3 0 0 0 3 0 0 0 3 0 0 0 3 0 0 0 3 0 0 0 3 0 0 0 3 0 0 0 3 0 0 0 3 
0 0 0 3 0 0 0 3 0 0 0 9 0 0 0 3 0 0 0 15 0 0 0 3 0 0 0 3 0 0 0 3 0 0 0 3 0 0 0 3 0 0 0 3 0 0 0 3 0 0 0 3 0 0 0 3 0 0 0 3 0 0 0 3 0 0 0 3 0 0 0 3 0 0 0 3 0 0 0 3 0 0 0 3 0 0 0 3 0 0 0 3 0 0 0 3 0 0 0 3 0 0 0 3 0 0 0 3 0 0 0 3 0 0 0 3 0 0 0 3 0 0 0 3 0 0 0 3 0 0 0 3 0 0 0 3 0 0 0 3 0 0 0 3 
0 0 0 3 0 0 0 3 0 0 0 3 1 11 2 7 2 20 0 0 64 9 55 17 58 17 36 51 35 41 0 47 55 21 16 11 2 24 20 21 39 31 27 44 27 29 27 2 23 50 1 34 15 17 6 41 40 34 3 36 38 37 6 53 35 25 37 43 7 28 18 63 52 19 48 27 1 12 38 26 42 2 49 15 6 0 1 4 0 0 0 3 0 0 0 3 0 0 0 3 0 0 0 3 0 0 0 3 0 0 0 3 0 0 0 3 0 0 0 3 0 0 0 3 0 0 0 3 0 0 0 3 0 0 0 3 0 0 0 3 0 0 0 3 0 0 0 3 0 0 0 3 0 0 0 3 0 0 0 3 0 0 0 3 0 0 0 3 0 0 0 3 0 0 0 3 0 0 0 3 0 0 0 3 0 0 0 3 0 0 0 3 0 0 0 3 0 0 0 3 0 0 0 3 0 0 0 3 0 0 0 3 0 0 0 3 
0 0 0 3 0 0 0 3 0 0 0 3 0 0 0 3 0 0 0 3 0 0 0 3 0 0 0 3 0 0 0 3 0 0 0 3 0 0 0 3 0 0 0 3 0 0 0 3 0 0 0 3 0 0 0 3 0 0 0 3 0 0 0 3 0 0 0 3 0 0 0 3 0 0 0 3 0 0 0 3 0 0 0 3 0 0 0 3 0 0 0 3 0 0 0 3 0 0 0 3 0 0 0 3 0 0 0 3 0 0 0 3 0 0 0 3 0 0 0 3 0 0 0 3 0 0 0 3 0 0 0 3 0 0 0 3 0 0 0 3 0 0 0 3 
0 0 0 3 2 8 0 2 0 0 0 3 0 0 0 3 0 0 0 3 0 0 0 3 1 2 6 7 2 20 0 0 64 9 55 17 5 17 36 51 35 41 0 47 55 21 24 11 2 24 20 21 39 31 27 44 27 29 27 2 23 50 1 31 15 17 6 41 40 34 3 36 38 37 6 53 35 25 37 43 7 28 18 57 52 19 48 27 1 12 38 26 42 34 49 15 6 5 0 6 0 0 0 3 0 0 0 3 2 3 0 0 0 0 0 3 0 0 0 3 0 0 0 3 0 0 0 3 0 0 0 3 0 0 0 3 0 0 0 3 0 0 0 3 0 0 0 3 0 0 0 3 0 0 0 3 0 0 0 3 0 0 0 3 0 0 0 3 0 0 0 3 0 0 0 3 0 0 0 3 0 0 0 3 0 0 0 3 0 0 0 3 0 0 0 3 0 0 0 3 0 0 0 3 0 0 0 3 0 0 0 7 1 2 6 7 2 20 0 0 64 9 55 17 5 17 36 51 35 41 0 47 55 21 16 11 25 24 20 21 39 31 27 44 27 29 27 2 23 50 1 31 15 17 6 41 40 34 3 36 38 37 6 53 35 25 37 43 7 28 9 63 52 19 48 27 1 12 38 26 42 34 49 15 60 3 0 13 
0 0 0 3 0 0 0 3 0 0 0 3 0 0 0 3 0 0 0 3 0 0 0 7 0 0 0 3 0 0 0 3 0 0 0 3 0 0 0 3 0 0 0 3 0 0 0 3 0 0 0 3 0 0 0 3 0 0 0 3 0 0 0 3 0 0 0 3 0 0 0 3 0 0 0 3 0 0 0 3 0 0 0 3 0 0 0 3 0 0 0 3 0 0 0 3 0 0 0 3 0 0 0 3 0 0 0 3 0 0 0 3 0 0 0 3 0 0 0 3 0 0 0 3 0 0 0 3 0 0 0 10 1 2 6 7 2 20 0 0 64 9 55 17 5 17 36 51 35 41 0 47 55 21 16 11 2 24 20 21 39 31 27 44 27 29 27 2 23 50 1 31 15 17 6 41 40 34 3 36 38 37 6 53 35 25 37 43 7 28 9 63 52 19 56 27 1 12 38 26 42 34 49 15 6 4 0 12 1 2 6 7 2 20 0 0 64 9 55 17 13 17 36 51 35 41 0 47 55 21 16 11 2 24 20 21 39 31 27 44 27 29 27 2 23 50 1 34 15 17 6 41 40 34 3 36 38 37 6 53 35 25 37 43 7 28 18 63 52 19 48 27 1 12 38 26 30 2 49 15 6 5 0 6 0 0 0 3 
0 0 0 3 0 0 0 3 0 0 0 3 0 0 0 7 0 0 0 6 0 0 0 3 0 0 0 3 0 0 0 3 0 0 0 3 0 0 0 3 0 0 0 3 0 0 0 3 0 0 0 3 0 0 0 3 0 0 0 3 0 0 0 3 1 2 6 7 2 20 0 0 64 9 55 17 5 17 36 51 35 41 0 47 55 21 24 11 2 24 20 21 39 31 27 44 27 62 54 2 23 50 1 31 15 17 6 41 40 34 3 48 38 37 6 53 35 25 37 43 7 28 18 63 52 19 48 27 1 12 38 26 42 34 49 15 6 5 0 6 0 0 0 3 0 0 0 3 0 0 0 3 0 0 0 3 0 0 0 3 0 0 0 3 0 0 0 3 0 0 0 3 0 0 0 3 0 0 0 3 0 0 0 3 0 0 0 3 0 0 0 3 1 2 6 7 2 20 0 0 64 9 55 17 5 17 36 51 35 41 38 47 55 21 16 11 2 24 20 21 39 31 27 44 27 29 27 2 23 50 1 31 15 17 6 41 40 34 3 36 38 37 6 53 35 25 37 43 7 28 9 63 52 19 56 27 1 12 38 26 42 34 49 15 6 5 0 6 0 0 0 9 0 0 0 7 0 0 0 7 0 0 0 3 0 0 0 3 
0 0 0 3 0 0 0 3 0 0 0 9 0 0 0 3 0 0 0 3 0 0 0 3 0 0 0 3 0 0 0 3 0 0 0 3 0 0 0 3 0 0 0 3 0 0 0 3 0 0 0 3 0 0 0 3 0 0 0 3 0 0 0 7 0 0 0 3 0 0 0 3 0 0 0 3 0 0 0 3 0 0 0 3 0 0 0 3 0 0 0 3 0 0 0 3 0 0 0 3 0 0 0 3 0 0 0 3 0 0 0 3 0 0 0 3 0 0 0 7 0 0 0 7 0 0 0 6 0 0 0 3 0 0 0 3 0 0 0 3 0 0 0 3 
0 0 0 3 0 0 0 3 0 0 0 3 0 0 0 3 0 0 0 3 0 0 0 3 0 0 0 3 0 0 0 3 0 0 0 3 0 0 0 3 0 0 0 3 0 0 0 3 0 0 0 3 0 0 0 7 0 0 0 6 0 0 0 3 1 2 6 7 2 20 0 0 64 9 55 17 5 17 36 51 35 41 0 47 55 21 24 11 2 24 20 21 39 31 27 44 27 29 27 2 23 50 1 31 15 17 6 41 40 34 3 36 38 37 6 53 35 25 37 43 7 28 18 57 52 19 48 55 1 12 38 26 42 34 49 15 6 5 0 6 0 0 0 3 0 0 0 3 0 0 0 3 0 0 0 3 0 0 0 3 0 0 0 3 0 0 0 3 0 0 0 3 0 0 0 3 0 0 0 3 0 0 0 7 0 0 0 6 0 0 0 9 0 0 0 3 0 0 0 3 0 0 0 3 0 0 0 3 0 0 0 3 0 0 0 3 
0 0 0 3 0 0 0 3 0 0 0 3 0 0 0 3 0 0 0 3 0 0 0 3 0 0 0 3 0 0 0 3 0 0 0 3 0 0 0 3 0 0 0 3 0 0 0 3 0 0 0 9 0 0 0 3 0 0 0 3 0 0 0 7 0 0 0 3 0 0 0 3 0 0 0 3 0 0 0 3 0 0 0 3 0 0 0 3 0 0 0 3 0 0 0 3 0 0 0 3 0 0 0 3 0 0 0 9 0 0 0 3 0 0 0 3 0 0 0 3 0 0 0 3 0 0 0 3 0 0 0 3 0 0 0 3 0 0 0 3 0 0 0 3 
0 0 0 3 0 0 0 3 0 0 0 3 0 0 0 -1 0 0 0 3 0 0 0 3 0 0 0 3 0 0 0 3 0 0 0 3 0 0 0 3 0 0 0 3 0 0 0 3 0 0 0 3 0 0 0 7 0 0 0 6 0 0 0 3 0 0 0 3 0 0 0 3 0 0 0 3 0 0 0 3 0 0 0 3 0 0 0 3 0 0 0 3 0 0 0 3 0 0 0 3 0 0 0 3 0 0 0 3 0 0 0 3 0 0 0 3 0 0 0 3 0 0 0 3 0 0 0 3 0 0 0 3 0 0 0 3 0 0 0 3 0 0 0 3 
0 0 0 3 0 0 0 3 0 0 0 3 0 0 0 14 0 0 0 3 0 0 0 3 0 0 0 3 0 0 0 3 0 0 0 3 0 0 0 18 0 0 0 -1 0 0 0 3 0 0 0 9 0 0 0 3 0 0 0 3 0 0 0 3 0 0 0 3 0 0 0 3 0 0 0 3 0 0 0 3 0 0 0 3 0 0 0 3 0 0 0 3 0 0 0 3 0 0 0 3 0 0 0 3 0 0 0 3 0 0 0 3 0 0 0 3 0 0 0 3 0 0 0 3 0 0 0 3 0 0 0 3 0 0 0 3 0 0 0 3 0 0 0 3 
0 0 0 3 0 0 0 3 0 0 0 3 0 0 0 3 0 0 0 3 0 0 0 3 0 0 0 3 0 0 0 3 0 0 0 3 0 0 0 3 0 0 0 3 1 2 6 7 2 20 0 0 64 9 55 17 5 17 36 51 35 41 0 47 55 21 16 11 2 24 20 21 39 31 27 44 27 12 27 2 23 50 1 34 15 17 6 41 40 34 3 36 38 37 6 53 35 25 37 43 7 28 18 63 52 19 48 27 1 12 38 26 42 15 49 15 6 5 0 6 0 0 0 3 0 0 0 3 0 0 0 3 0 0 0 3 0 0 0 3 0 0 0 3 0 0 0 3 0 0 0 3 0 0 0 3 0 0 0 3 0 0 0 3 0 0 0 3 0 0 0 3 0 0 0 3 0 0 0 3 0 0 0 3 0 0 0 3 0 0 0 3 0 0 0 3 0 0 0 3 0 0 0 3 0 0 0 3 0 0 0 3 0 0 0 3 
0 0 0 3 0 0 0 3 0 0 0 3 0 0 0 3 0 0 0 3 0 0 0 3 0 0 0 3 0 0 0 3 0 0 0 3 0 0 0 3 0 0 0 7 0 0 0 3 0 0 0 3 0 0 0 3 0 0 0 3 0 0 0 3 0 0 0 3 0 0 0 3 0 0 0 3 1 2 6 7 2 20 0 0 64 9 55 17 5 17 36 51 35 41 0 47 55 21 24 11 2 24 20 3 39 31 27 44 27 29 27 2 23 50 1 31 15 17 6 41 40 34 3 36 38 37 6 53 35 25 37 43 7 28 18 57 52 19 48 27 1 12 38 26 42 34 49 15 6 5 0 6 0 0 0 3 0 0 0 3 0 0 0 3 0 0 0 3 0 0 0 3 0 0 0 3 0 0 0 3 0 0 0 3 1 2 6 7 2 20 0 0 64 9 55 17 5 17 36 51 35 41 0 47 55 21 24 15 2 24 20 21 39 31 27 44 27 29 27 2 23 50 1 31 15 17 6 41 40 34 51 36 38 37 6 53 35 25 37 43 7 28 18 63 52 19 48 27 1 12 38 26 42 34 49 15 6 5 0 6 0 0 0 3 0 0 0 3 0 0 0 3 0 0 0 3 0 0 0 3 0 0 0 3 0 0 0 3 
0 0 0 3 0 0 0 3 0 0 0 3 0 0 0 3 0 0 0 3 0 0 0 3 0 0 0 3 1 2 6 7 2 20 0 0 64 9 55 17 5 17 36 51 35 41 0 47 55 21 24 11 2 24 20 21 39 31 27 44 27 29 54 2 23 50 1 31 15 17 6 41 40 34 3 36 38 37 6 53 35 25 37 43 7 28 18 63 52 19 48 27 1 12 38 26 42 34 15 15 6 5 0 6 0 0 0 7 0 0 0 6 0 0 0 3 0 0 0 3 0 0 0 -1 1 2 6 7 2 20 0 0 64 9 55 17 5 17 36 51 35 41 0 47 55 21 24 11 2 24 20 21 39 31 27 44 27 29 54 2 23 50 1 31 15 17 6 41 40 34 3 36 38 37 6 53 35 25 37 43 7 28 18 63 52 19 48 27 1 12 38 26 42 34 49 15 6 5 0 6 0 0 0 3 0 0 0 3 0 0 0 3 0 0 0 3 0 0 0 7 0 0 0 3 0 0 0 3 0 0 0 3 0 0 0 3 0 0 0 3 0 0 0 3 0 0 0 3 0 0 0 3 0 0 0 7 0 0 0 3 0 0 0 3 0 0 0 3 0 0 0 3 0 0 0 3 0 0 0 3 0 0 0 3 0 0 0 3 
0 0 0 3 0 0 0 3 0 0 0 3 0 0 0 3 0 0 0 3 0 0 0 3 0 0 0 7 0 0 0 9 0 0 0 3 0 0 0 3 0 0 0 3 0 0 0 3 1 2 6 7 2 20 0 0 64 9 55 17 5 17 36 51 35 41 0 47 55 21 16 11 25 10 20 21 39 31 27 44 27 29 27 2 23 50 1 31 15 17 6 41 40 34 3 36 38 37 6 53 35 25 37 43 7 28 9 63 52 19 48 27 1 12 38 26 42 34 49 15 6 3 0 10 0 0 0 3 0 0 0 3 0 0 0 3 0 0 0 7 0 0 0 6 0 0 0 3 0 0 0 3 0 0 0 3 0 0 0 3 0 0 0 3 0 0 0 3 1 2 6 7 2 20 0 0 64 9 55 17 5 17 36 51 35 41 0 47 55 21 24 15 2 24 20 21 39 31 27 29 27 29 27 2 23 50 1 31 15 17 6 41 40 34 51 36 38 37 6 53 35 25 37 43 7 28 18 63 52 19 48 27 1 12 38 26 42 34 49 15 6 5 0 6 0 0 0 7 0 0 0 6 0 0 0 3 0 0 0 3 0 0 0 3 0 0 0 3 0 0 0 3 0 0 0 3 0 0 0 3 0 0 0 3 1 2 6 7 2 20 0 0 64 9 55 17 5 17 36 51 35 41 0 47 55 21 16 11 25 24 20 21 39 31 27 44 27 29 27 2 23 50 1 31 15 17 6 41 40 34 3 36 38 37 6 53 35 25 37 43 7 28 9 63 52 19 48 27 1 12 38 26 46 34 49 15 6 5 0 10 
0 0 0 3 0 0 0 3 0 0 0 3 0 0 0 3 1 2 6 7 2 20 0 0 64 9 55 17 5 17 36 51 35 41 0 47 55 21 16 11 2 24 20 21 39 31 27 44 27 29 27 2 23 50 1 31 15 17 6 41 40 34 3 36 38 37 6 53 35 25 37 43 7 28 9 63 52 19 56 27 1 12 38 26 42 8 49 15 6 3 0 10 0 0 0 6 0 0 0 3 0 0 0 3 0 0 0 3 0 0 0 3 0 0 0 7 0 0 0 10 0 0 0 3 0 0 0 3 0 0 0 3 0 0 0 9 0 0 0 3 0 0 0 3 0 0 0 3 0 0 0 3 0 0 0 3 0 0 0 3 0 0 0 3 0 0 0 7 0 0 0 9 0 0 0 3 0 0 0 3 0 0 0 3 0 0 0 3 0 0 0 3 0 0 0 3 0 0 0 3 0 0 0 3 0 0 0 7 0 0 0 6 0 0 0 3 
0 0 0 3 2 10 0 3 0 0 0 3 0 0 0 13 0 0 0 3 0 0 0 3 0 0 0 3 0 0 0 3 0 0 0 3 0 0 0 13 0 0 0 6 0 0 0 3 0 0 0 3 0 0 0 3 0 0 0 -1 0 0 0 3 0 0 0 3 0 0 0 3 0 0 0 3 0 0 0 3 0 0 0 3 1 2 6 7 2 20 0 0 64 9 55 17 5 17 36 51 35 41 0 15 55 21 16 11 25 24 20 21 39 31 27 44 27 29 27 2 23 50 1 31 15 17 6 41 40 34 3 36 38 37 6 53 35 25 37 43 7 28 9 63 52 19 48 27 1 12 38 26 42 34 49 15 6 3 0 10 0 0 0 6 0 0 0 3 0 0 0 3 0 0 0 3 0 0 0 3 0 0 0 3 0 0 0 3 0 0 0 3 0 0 0 3 0 0 0 3 0 0 0 9 0 0 0 3 0 0 0 3 0 0 0 3 
0 0 0 3 0 0 0 7 0 0 0 6 0 0 0 3 0 0 0 3 0 0 0 3 0 0 0 3 0 0 0 3 0 0 0 9 0 0 0 3 0 0 0 3 0 0 0 3 0 0 0 3 0 0 0 3 0 0 0 3 0 0 0 3 0 0 0 3 0 0 0 10 0 0 0 3 0 0 0 3 0 0 0 13 0 0 0 3 0 0 0 3 0 0 0 3 0 0 0 3 0 0 0 3 0 0 0 3 0 0 0 3 0 0 0 3 0 0 0 3 0 0 0 3 0 0 0 3 0 0 0 3 0 0 0 3 0 0 0 3 0 0 0 3 
0 0 0 9 0 0 0 3 0 0 0 3 0 0 0 3 0 0 0 3 0 0 0 3 0 0 0 3 0 0 0 3 0 0 0 -1 0 0 0 3 0 0 0 3 0 0 0 3 0 0 0 3 0 0 0 3 0 0 0 3 0 0 0 3 0 0 0 6 0 0 0 7 1 5 5 7 2 20 0 0 64 9 55 17 5 17 36 51 35 41 0 47 55 21 24 11 2 24 20 21 39 31 27 44 27 29 54 2 23 50 1 31 15 17 6 41 40 34 3 36 38 37 6 53 35 25 37 43 7 28 18 63 52 19 48 27 1 12 25 1 42 34 49 15 6 5 0 9 0 0 0 6 1 2 6 7 2 20 0 0 64 9 55 17 5 17 36 51 35 41 0 47 55 21 24 11 2 24 20 21 39 31 27 44 27 29 27 2 23 50 1 31 15 17 6 41 40 34 3 36 38 37 6 53 35 25 37 43 7 28 18 57 52 19 48 27 1 12 38 26 42 34 49 15 6 5 0 6 0 0 0 3 0 0 0 3 0 0 0 3 0 0 0 3 0 0 0 3 0 0 0 3 0 0 0 3 0 0 0 3 0 0 0 3 0 0 0 3 0 0 0 3 0 0 0 3 0 0 0 3 0 0 0 3 0 0 0 3 
0 0 0 3 0 0 0 3 0 0 0 3 0 0 0 3 0 0 0 3 0 0 0 3 0 0 0 3 0 0 0 3 0 0 0 3 0 0 0 3 0 0 0 3 0 0 0 3 1 2 6 7 2 20 0 0 64 9 55 17 5 17 36 51 35 41 0 47 55 21 24 11 2 24 16 21 39 31 27 44 27 29 54 2 23 50 1 31 15 17 6 41 40 34 3 36 38 37 6 53 35 25 37 43 7 28 18 63 52 19 48 27 1 12 38 1 42 34 49 15 6 5 0 6 0 0 0 3 0 0 0 3 0 0 0 3 0 0 0 7 0 0 0 9 0 0 0 3 0 0 0 7 0 0 0 3 0 0 0 3 0 0 0 3 0 0 0 3 0 0 0 3 0 0 0 3 0 0 0 3 0 0 0 3 0 0 0 3 0 0 0 3 0 0 0 3 0 0 0 3 0 0 0 3 0 0 0 3 0 0 0 3 0 0 0 3 
0 0 0 3 0 0 0 3 0 0 0 3 0 0 0 3 0 0 0 3 0 0 0 3 0 0 0 3 0 0 0 3 0 0 0 3 0 0 0 3 0 0 0 3 0 0 0 7 0 0 0 3 0 0 0 3 0 0 0 3 0 0 0 3 0 0 0 3 0 0 0 7 0 0 0 6 0 0 0 3 0 0 0 3 0 0 0 3 0 0 0 3 0 0 0 3 0 0 0 3 0 0 0 3 0 0 0 3 0 0 0 3 0 0 0 3 0 0 0 3 0 0 0 3 0 0 0 3 0 0 0 3 0 0 0 3 0 0 0 3 0 0 0 18 
0 0 0 3 0 0 0 3 0 0 0 3 0 0 0 3 0 0 0 3 0 0 0 3 0 0 0 3 0 0 0 3 0 0 0 3 0 0 0 7 0 0 0 6 0 0 0 3 0 0 0 3 0 0 0 3 0 0 0 3 0 0 0 3 0 0 0 9 1 2 6 7 2 20 0 0 64 9 55 17 5 17 36 51 35 41 0 47 55 20 16 11 2 24 20 21 39 31 27 44 27 29 27 2 23 15 1 31 15 17 6 41 40 34 3 36 38 37 6 53 35 25 37 43 7 28 18 63 52 19 48 27 1 12 38 26 42 34 49 15 6 5 0 6 0 0 0 3 0 0 0 3 0 0 0 3 0 0 0 3 0 0 0 3 0 0 0 3 0 0 0 3 0 0 0 3 0 0 0 3 1 2 6 7 2 20 0 0 64 9 55 17 5 17 36 51 35 41 0 47 55 21 24 15 2 24 20 21 39 31 27 44 27 29 27 2 23 50 1 31 15 17 6 41 40 34 51 36 38 37 6 53 35 25 37 43 7 28 18 63 52 19 48 27 1 12 38 26 42 34 49 15 6 5 0 6 0 0 0 3 0 0 0 3 0 0 0 3 0 0 0 3 0 0 0 3 0 0 0 3 0 0 0 -1 0 0 0 3 
0 0 0 3 0 0 0 3 0 0 0 3 0 0 0 10 0 0 0 3 1 2 6 7 2 20 0 0 64 9 55 17 13 17 36 51 35 41 0 47 55 21 16 11 2 24 20 21 39 31 27 44 27 29 27 2 23 50 1 34 15 17 6 41 40 34 3 36 38 37 6 53 35 25 63 43 7 28 18 63 52 19 48 27 1 12 38 26 42 2 49 15 6 5 0 6 0 0 0 3 0 0 0 3 0 0 0 9 0 0 0 3 0 0 0 3 0 0 0 3 0 0 0 3 0 0 0 3 0 0 0 3 0 0 0 3 0 0 0 7 0 0 0 3 0 0 0 3 0 0 0 3 0 0 0 3 0 0 0 3 0 0 0 3 0 0 0 3 0 0 0 3 0 0 0 3 0 0 0 7 0 0 0 3 0 0 0 3 0 0 0 3 0 0 0 3 0 0 0 3 0 0 0 3 0 0 0 3 0 0 0 3 0 0 0 3 
0 0 0 3 0 0 0 3 0 0 0 9 0 0 0 3 0 0 0 7 0 0 0 3 0 0 0 3 0 0 0 3 0 0 0 3 0 0 0 3 0 0 0 3 0 0 0 3 0 0 0 3 0 0 0 3 0 0 0 7 0 0 0 6 0 0 0 3 0 0 0 3 0 0 0 3 0 0 0 3 0 0 0 3 0 0 0 3 0 0 0 3 0 0 0 3 0 0 0 7 0 0 0 6 0 0 0 3 0 0 0 3 0 0 0 3 0 0 0 3 0 0 0 3 0 0 0 3 0 0 0 3 0 0 0 3 0 0 0 3 0 0 0 3 
0 0 0 3 0 0 0 3 0 0 0 3 0 0 0 3 0 0 0 3 0 0 0 3 0 0 0 3 0 0 0 3 0 0 0 3 0 0 0 3 0 0 0 3 0 0 0 3 0 0 0 3 0 0 0 9 0 0 0 3 0 0 0 3 0 0 0 3 0 0 0 3 0 0 0 3 0 0 0 3 0 0 0 3 0 0 0 3 0 0 0 3 0 0 0 9 0 0 0 3 0 0 0 3 0 0 0 3 0 0 0 3 0 0 0 3 1 2 6 7 2 20 0 0 64 9 55 17 5 17 36 51 35 41 0 47 55 21 24 11 2 24 20 21 39 31 27 44 27 62 54 2 23 50 1 31 15 17 6 41 40 34 3 36 38 13 6 53 35 25 37 43 7 28 18 63 52 19 48 27 1 12 38 26 42 34 49 15 6 5 0 6 0 0 0 3 0 0 0 3 0 0 0 3 0 0 0 3 0 0 0 3 0 0 0 3 
0 0 0 3 0 0 0 3 0 0 0 3 0 0 0 3 0 0 0 3 0 0 0 3 1 2 6 7 2 20 0 0 64 9 55 17 5 17 36 51 35 41 0 47 55 21 16 11 2 24 20 21 39 31 27 44 27 29 27 2 23 15 1 31 15 17 6 41 40 34 3 36 38 37 6 53 35 25 37 43 7 28 18 63 52 19 48 27 1 12 38 26 42 34 49 15 6 5 0 6 0 0 0 3 1 2 6 7 2 20 0 0 64 9 55 17 5 17 36 51 35 41 0 47 55 21 16 11 2 24 20 21 39 31 27 44 27 29 27 2 23 50 1 34 15 17 6 41 40 34 3 36 38 37 6 53 35 25 37 43 7 28 18 63 17 19 48 27 1 12 38 26 42 15 49 15 6 5 0 6 0 0 0 3 0 0 0 3 0 0 0 3 0 0 0 3 0 0 0 3 1 2 6 7 2 20 0 0 64 9 55 17 5 17 36 51 35 41 0 47 55 21 16 11 25 24 20 21 39 31 27 54 27 29 27 2 23 50 1 31 15 17 6 41 40 34 3 36 38 37 6 53 35 25 37 43 7 28 9 63 52 19 48 27 1 12 38 26 42 34 49 15 6 5 0 6 0 0 0 3 0 0 0 3 0 0 0 3 0 0 0 3 0 0 0 3 0 0 0 3 0 0 0 3 0 0 0 3 0 0 0 3 0 0 0 -1 0 0 0 3 0 0 0 3 0 0 0 3 0 0 0 7 0 0 0 3 0 0 0 3 0 0 0 3 0 0 0 3 1 2 6 7 2 20 0 0 64 9 55 17 5 17 36 51 35 41 0 47 55 21 16 11 2 24 20 21 39 31 27 44 27 29 27 2 23 50 1 34 15 17 6 41 40 34 3 36 38 37 6 53 35 25 37 43 7 28 18 63 52 19 48 27 1 12 38 26 42 15 49 15 6 5 0 6 0 0 0 3 0 0 0 3 
0 0 0 3 0 0 0 3 0 0 0 3 0 0 0 3 0 0 0 3 0 0 0 7 0 0 0 3 0 0 0 7 0 0 0 3 0 0 0 3 0 0 0 3 0 0 0 3 0 0 0 3 0 0 0 7 0 0 0 3 0 0 0 3 0 0 0 3 0 0 0 3 0 0 0 3 0 0 0 3 0 0 0 3 0 0 0 3 0 0 0 3 0 0 0 -1 0 0 0 3 0 0 0 3 0 0 0 7 0 0 0 6 0 0 0 3 0 0 0 3 0 0 0 3 0 0 0 3 0 0 0 7 0 0 0 3 0 0 0 3 0 0 0 3 
0 0 0 3 0 0 0 3 0 0 0 3 0 0 0 7 0 0 0 6 0 0 0 7 0 0 0 6 1 2 6 7 2 20 0 0 64 9 55 17 5 17 36 51 35 41 0 47 55 21 24 15 2 24 20 21 39 31 27 44 27 29 27 2 23 50 1 31 15 17 6 41 40 34 51 36 38 37 6 53 35 25 37 43 7 28 18 63 52 25 48 27 1 12 38 26 42 34 49 15 6 5 0 6 0 0 0 3 0 0 0 3 0 0 0 3 0 0 0 7 0 0 0 6 0 0 0 3 0 0 0 3 0 0 0 3 0 0 0 3 0 0 0 3 0 0 0 3 0 0 0 3 0 0 0 3 0 0 0 3 0 0 0 3 0 0 0 3 0 0 0 3 0 0 0 9 0 0 0 3 0 0 0 3 0 0 0 3 0 0 0 3 0 0 0 7 0 0 0 6 0 0 0 3 0 0 0 3 0 0 0 3 0 0 0 3 
0 0 0 3 0 0 0 3 0 0 0 9 0 0 0 3 0 0 0 9 0 0 0 3 0 0 0 7 0 0 0 3 0 0 0 3 0 0 0 3 0 0 0 9 0 0 0 3 0 0 0 3 0 0 0 3 0 0 0 3 0 0 0 3 0 0 0 3 0 0 0 3 0 0 0 3 0 0 0 3 0 0 0 3 0 0 0 3 0 0 0 3 0 0 0 3 0 0 0 3 0 0 0 3 0 0 0 3 0 0 0 3 0 0 0 3 0 0 0 9 0 0 0 3 0 0 0 3 0 0 0 3 0 0 0 3 0 0 0 3 0 0 0 3 
0 0 0 3 0 0 0 3 0 0 0 3 0 0 0 3 0 0 0 7 0 0 0 6 0 0 0 3 0 0 0 3 0 0 0 3 0 0 0 3 0 0 0 3 0 0 0 3 0 0 0 3 0 0 0 3 0 0 0 3 0 0 0 3 0 0 0 3 0 0 0 3 0 0 0 3 0 0 0 3 0 0 0 3 0 0 0 3 0 0 0 3 0 0 0 3 0 0 0 3 0 0 0 3 0 0 0 3 0 0 0 3 0 0 0 3 0 0 0 3 0 0 0 3 0 0 0 3 0 0 0 3 0 0 0 3 0 0 0 7 0 0 0 6 
0 0 0 3 0 0 0 3 0 0 0 3 0 0 0 9 0 0 0 3 0 0 0 3 0 0 0 3 0 0 0 3 0 0 0 3 0 0 0 3 0 0 0 3 0 0 0 3 0 0 0 3 0 0 0 3 0 0 0 3 0 0 0 3 0 0 0 3 0 0 0 3 0 0 0 3 0 0 0 3 0 0 0 3 0 0 0 3 0 0 0 3 0 0 0 3 0 0 0 3 1 2 6 7 2 20 0 0 64 9 55 17 5 17 36 51 35 41 0 47 55 21 16 11 2 24 20 21 39 31 14 44 27 29 27 2 23 50 1 34 15 17 6 41 40 34 3 36 38 37 6 53 35 25 37 43 7 28 18 63 52 19 48 27 1 12 38 26 42 15 49 15 6 5 0 6 0 0 0 3 0 0 0 3 0 0 0 3 0 0 0 3 0 0 0 3 0 0 0 3 0 0 0 3 0 0 0 9 0 0 0 3 1 2 6 7 2 20 0 0 64 9 55 17 5 12 36 51 35 41 0 47 55 21 24 11 2 24 20 21 39 31 27 44 27 29 54 2 23 50 1 31 15 17 6 41 40 34 3 36 38 37 6 53 35 25 37 43 7 28 18 63 52 19 48 27 1 12 38 1 42 34 49 15 6 5 0 10 
0 0 0 3 0 0 0 3 0 0 0 3 0 0 0 3 0 0 0 -1 0 0 0 3 0 0 0 3 0 0 0 3 0 0 0 3 0 0 0 3 0 0 0 3 0 0 0 3 0 0 0 3 0 0 0 3 0 0 0 3 0 0 0 3 0 0 0 3 1 2 6 7 2 20 0 0 64 9 55 17 5 17 36 51 35 41 0 47 55 21 24 15 2 24 20 21 39 31 27 44 27 29 27 2 23 50 1 31 15 17 6 41 40 58 51 36 38 37 6 53 35 25 37 43 7 28 18 63 52 19 48 27 1 12 38 26 42 34 49 15 6 5 0 6 0 0 0 3 0 0 0 3 0 0 0 3 0 0 0 3 0 0 0 3 0 0 0 3 0 0 0 7 0 0 0 -1 0 0 0 3 1 2 6 7 2 20 0 0 64 9 55 17 5 17 36 51 6 41 0 47 55 21 24 11 2 24 20 21 39 31 27 44 27 29 27 2 23 50 1 31 15 17 6 41 40 34 3 36 38 37 6 53 35 25 37 43 7 28 18 57 52 19 48 27 1 12 38 26 42 34 49 15 6 5 0 6 0 0 0 3 0 0 0 3 0 0 0 3 1 2 6 7 2 20 0 0 64 9 55 17 5 17 36 51 35 41 0 47 55 21 16 11 2 24 20 21 39 31 27 44 27 29 27 2 23 15 1 31 15 17 6 41 40 34 3 36 38 37 6 53 35 25 17 43 7 28 18 63 52 19 48 27 1 12 38 26 42 34 49 15 6 5 0 6 0 0 0 3 0 0 0 3 0 0 0 3 0 0 0 3 
0 0 0 3 0 0 0 3 0 0 0 3 0 0 0 3 0 0 0 3 0 0 0 3 0 0 0 3 0 0 0 3 0 0 0 3 0 0 0 3 0 0 0 3 0 0 0 3 0 0 0 3 0 0 0 3 0 0 0 3 0 0 0 3 0 0 0 7 0 0 0 3 0 0 0 3 0 0 0 3 0 0 0 3 0 0 0 3 0 0 0 7 0 0 0 6 0 0 0 3 0 0 0 3 0 0 0 7 0 0 0 3 0 0 0 3 0 0 0 3 0 0 0 7 0 0 0 3 0 0 0 3 0 0 0 3 0 0 0 3 1 2 6 7 2 20 0 0 64 9 55 17 5 17 36 51 35 41 0 47 55 21 24 11 2 24 20 21 39 31 27 44 27 29 54 2 23 50 1 31 15 17 6 41 40 34 3 36 38 37 6 53 35 25 37 43 7 28 18 63 52 19 48 27 1 12 38 1 42 34 49 15 6 5 0 6 
0 0 0 3 0 0 0 3 0 0 0 3 0 0 0 3 0 0 0 3 0 0 0 3 0 0 0 3 0 0 0 3 0 0 0 3 0 0 0 3 0 0 0 3 0 0 0 3 0 0 0 3 0 0 0 3 0 0 0 7 0 0 0 6 0 0 0 3 0 0 0 3 0 0 0 3 0 0 0 3 0 0 0 3 0 0 0 9 0 0 0 3 0 0 0 3 0 0 0 7 0 0 0 6 0 0 0 3 0 0 0 3 0 0 0 7 0 0 0 6 0 0 0 3 0 0 0 3 0 0 0 3 0 0 0 3 0 0 0 7 0 0 0 3 
0 0 0 3 0 0 0 3 0 0 0 3 0 0 0 3 0 0 0 3 0 0 0 3 0 0 0 3 0 0 0 3 1 2 6 7 2 20 0 0 64 9 55 17 5 17 36 51 35 41 0 47 55 21 16 11 2 24 20 21 39 31 27 44 27 29 27 2 23 50 1 31 15 1 6 41 40 34 3 36 38 37 6 53 35 25 37 43 7 28 9 63 52 19 56 27 1 12 38 26 42 34 49 15 6 5 0 6 0 0 0 3 0 0 0 3 0 0 0 3 0 0 0 3 0 0 0 9 0 0 0 3 0 0 0 3 0 0 0 3 0 0 0 3 0 0 0 3 0 0 0 3 0 0 0 3 0 0 0 3 0 0 0 3 0 0 0 9 0 0 0 3 0 0 0 3 0 0 0 3 0 0 0 9 0 0 0 3 0 0 0 3 0 0 0 3 0 0 0 3 0 0 0 7 0 0 0 6 0 0 0 3 1 2 6 7 2 20 0 0 64 9 55 17 5 17 36 51 35 41 0 47 55 21 24 11 2 24 20 21 39 31 27 44 27 62 54 2 23 50 1 31 15 17 6 41 40 34 3 36 38 37 6 53 35 25 37 43 7 28 18 63 52 44 48 27 1 12 38 26 42 34 49 15 6 5 0 6 
0 0 0 3 0 0 0 3 0 0 0 3 0 0 0 3 0 0 0 3 0 0 0 3 0 0 0 3 0 0 0 4 0 0 0 6 0 0 0 3 0 0 0 3 0 0 0 3 0 0 0 3 0 0 0 3 0 0 0 3 0 0 0 3 0 0 0 3 0 0 0 3 0 0 0 3 0 0 0 3 0 0 0 3 0 0 0 3 0 0 0 3 0 0 0 3 0 0 0 3 0 0 0 3 0 0 0 3 1 2 6 7 2 20 0 0 64 9 55 17 5 17 36 51 35 41 0 47 55 21 24 11 2 24 33 21 39 31 27 44 27 62 54 2 23 50 1 31 15 17 6 41 40 34 3 36 38 37 6 53 35 25 37 43 7 28 18 63 52 19 48 27 1 12 38 26 42 34 49 15 6 5 0 6 0 0 0 3 0 0 0 3 0 0 0 3 0 0 0 9 0 0 0 3 0 0 0 3 0 0 0 7 0 0 0 3 
0 0 0 3 0 0 0 3 0 0 0 3 0 0 0 3 0 0 0 3 0 0 0 3 0 0 0 7 0 0 0 6 0 0 0 3 0 0 0 3 0 0 0 3 0 0 0 3 0 0 0 3 0 0 0 3 0 0 0 3 0 0 0 3 0 0 0 3 0 0 0 3 0 0 0 3 0 0 0 3 0 0 0 -1 0 0 0 3 0 0 0 3 0 0 0 3 0 0 0 3 0 0 0 3 0 0 0 7 0 0 0 3 0 0 0 3 0 0 0 3 0 0 0 3 0 0 0 3 0 0 0 7 0 0 0 6 0 0 0 7 1 4 5 7 2 20 0 0 64 9 55 17 5 17 36 51 35 41 0 47 55 21 24 11 2 24 20 21 39 31 27 44 27 29 54 2 23 50 1 31 15 17 6 41 40 34 3 36 38 37 55 53 35 25 37 43 7 28 18 63 52 19 48 27 1 12 38 26 42 34 49 15 6 4 0 0 
